############
#  #       #
#  #    #Q #
#       ####
#  ###  #  #
#  #    #  #
#r #       #
############
